111111111111
1E0P00000CC1
100C00C00C00
1C0C0C0C0CE1
111111111111
