1111111111111111111
1111111111111111111
1000000000000000001
1000000000000000001
1111111111111111111
1111111111111111111
1C00000000C000000E1
1E00000000000000001
1111110000000000001
1000000000000000001
10000C0C0C0C0000001
1000000000000000001
1000000000000000001
10000C0C0C0C0000001
1000000000000000001
1000001111100000001
1000000000000000001
10000C0C0C0C0000001
1000000000000000001
10000C0C0C0C0000001
1000000000000000001
10000C0C100CP000011
1000000000000000001
1000001111100000001
10000C0C1C0C0000001
1000000000000000001
10000C0C1C0C00000E1
1111111111111111111
1111111111111111111
1000000000000000001
1111111111111111111
1111111111111111111
