NO ./resources/textures/black_brick.xpm
WE ./resources/textures/blue_brick.xpm
SO ./resources/textures/grey_brick.xpm
EA ./resources/textures/sable_brick.xpm
F 23,21,32
C 209,205,222

   11111111      11111111
  1100000011    1100000011
 110000000011  110000000011
1100000000001111000000000011
1110001000001111000010000011
1100000000000000000000000011
1100000000001111000000100011
 110000000011  110000000011
  1100000011    1100000011
   11001111      11110011
   11001111      11110011
  1100000011    1100000011
 110000000011  110000000011
1100000000001111000011100011
1100000000000000000011100011
110000N000000000000000011011
1100000000001111000000011011
 110000000011  110000000011
  1100000011    1100000011
   11111111      11111111
