NO ./resources/textures/black_brick.xpm
WE ./resources/textures/blue_brick.xpm
SO ./resources/textures/grey_brick.xpm
EA ./resources/textures/sable_brick.xpm
F 23,21,32
C 209,205,222
1111111111
1001000001
1000010001
1100N00001
1000000001
1110000001
1000100001
1111111111
