NO ./resources/textures/black_brick.xpm
WE ./resources/textures/blue_brick.xpm
SO ./resources/textures/grey_brick.xpm
EA ./resources/textures/sable_brick.xpm
F 100,20,0
C 0,-1000,30
11111111111111111
11011100111101111
10001100000001111
10000000100000111
10000000000000001
11110000N00000001
10000000000000001
10000000000110001
11111111111111111
