NO ./resources/textures/black_brick.xpm
WE ./resources/textures/blue_brick.xpm
SO ./resources/textures/grey_brick.xpm
EA ./resources/textures/sable_brick.xpm
F 23,21,32
C 209,205,222
1111J1
100101
10000
11000011
111111
