
WE                      ./textures/img_Wall.xpm
NO   ./textures/img_Collect.xpm

SO       ./textures/img_Exit.xpm
EA ./textures/img_Player.xpm



F          16,12,39
C          214,+0,    124



        1111111111111111111111111
        1000000000110000000000001
        1011000001110000001000001
        1001000000000000000000001
111111111011000001110000000000001
100000000011000001110111111111111
11110111111111011100000010001
11110111111111011101010010001
11000000110101011100000010001
10001000000000001100000010001
10000000000000001101010000001
11000001110101011111011110N0111
11110111 1110101 101111010001
11111111 1111111 111111111111


