NO ./textures/red.xpm
WE ./textures/purplestone.xpm
SO ./textures/bluestone.xpm
EA ./textures/greystone.xpm
F 95,255,218
C 163,95,255


   111   111 111  111
   101   101 101  101
   101   101 101  101
   101   101 101  101
   101   101 101  101
   101111101110111101
   100000111000000001
   1000011 1000000001
   1000001110S0000001
   111111111111111111




