NO textures/purp_wall.xpm
SO textures/pink_wall.xpm
WE textures/blue_wall.xpm
EA textures/green_wall.xpm

F 74,171,0
C 37,150,190

1111111111111
100000E000001
1000000000001
1111111111111