NO ./textures/red.xpm
WE ./textures/purplestone.xpm
SO ./textures/bluestone.xpm
EA ./textures/greystone.xpm
F 100,20,0
C 0,30,0
11111111111111111
11011100111101111
10001100000001111
10000000100000111
10000000000000001
11110000N00     1
10000000000000001
10000000000110001
11111111111111111
