NO ./textures/red.xpm
WE ./textures/purplestone.xpm
SO ./textures/bluestone.xpm
EA ./textures/greystone.xpm
S 90,40,0
F 100,20,0
C 0,30,100
111111
100101
100001
1100N1
111111
