NO ./textures/red.xpm
WE ./textures/purplestone.xpm
SO ./textures/bluestone.xpm
EA ./textures/greystone.xpm
F 100,20,0
C 0,30,100
1111J1
100101
10000
11000011
111111
