
NO   ./textures/walkstone.xpm
WE                      ./textures/stone.xpm

SO       ./textures/coal.xpm
EA ./textures/leavests.xpm



F          0,0,0
C          255,255,255



        1111111111111111111111111
        100000000011000E000000001
        1011000001110000001000001
        1001000000000000000000001
111111111011000001110000000000001
100000000011000001110111111111111
11110111111111011100000010001
11110111111111011101010010001
11000000110101011100000010001
10001000000000001100000010001
10000000000000001101010000001
110000011101010111110111100111
11110111 1110101 101111010001
11111111 1111111 111111111111


