
NO   ./textures/star.xpm
WE                      ./textures/blueblue.xpm

SO       ./textures/greengreen.xpm
EA ./textures/purplepurple.xpm



F          0,0,0
C          255,255,255



111111111111111111111111111111111111111111111111111111111111111111111111111111111111111111111111111111111111111111111111
1E0000000000000000000000000001100000000000000000000000000000000000000000000000000000011000000000000000000000000000000001
100000000000000000000000000000000000000000000000000000000000000000000000000000000000000000000000000000000000000000000001
111111111111111111111111111111111111111111111111111111111111111111111111111111111111111111111111111111111111111111111111

