NO ./textures/red.xpm
WE ./textures/purplestone.xpm
SO ./textures/bluestone.xpm
EA ./textures/greystone.xpm


F 100,20,0
C 0,30,0
111111
1001011
1000N1
1100011
111111
